{
  "levels": [
    {
      "name":"第一关",
      "level_list": [
        [0, 0, 1, 0, 0],
        [0, 1, 0, 1, 0],
        [1, 0, 1, 1, 1],
        [0, 1, 1, 1, 0],
        [0, 0, 1, 0, 0]
]
    },
    {
      "name":"第二关",
      "level_list":[
           [0, 0, 0, 0, 0, 0, 0, 0, 0, 0],
           [0, 0, 0, 0, 0, 1, 0, 0, 0, 0],
           [0, 0, 0, 0, 0, 1, 0, 0, 0, 0],
           [0, 0, 0, 0, 1, 1, 0, 0, 0, 0],
           [0, 0, 0, 0, 1, 1, 0, 0, 0, 0],
           [0, 0, 0, 1, 1, 1, 1, 0, 0, 0],
           [0, 0, 1, 1, 1, 1, 1, 1, 0, 0],
           [1, 1, 1, 1, 1, 1, 1, 1, 1, 1],
           [0, 1, 1, 1, 1, 1, 1, 1, 1, 0],
           [0, 0, 1, 1, 1, 1, 1, 1, 0, 0]
]
    },
    {
      "name":"第三关",
      "level_list":[
           [0, 0, 0, 0, 0, 0, 0, 0, 0],
           [0, 1, 1, 0, 0, 0, 1, 1, 0],
           [1, 1, 1, 1, 0, 1, 1, 1, 1],
           [1, 1, 1, 1, 1, 1, 1, 1, 1],
           [1, 0, 1, 0, 1, 0, 1, 0, 1],
           [0, 1, 1, 1, 1, 1, 1, 1, 0],
           [0, 0, 1, 1, 1, 1, 1, 0, 0],
           [0, 0, 0, 1, 1, 1, 0, 0, 0],
           [0, 0, 0, 0, 1, 0, 0, 0, 0],
           [0, 0, 0, 0, 0, 0, 0, 0, 0]
]
    }
  ]
}

